 
everyone - всем, все
hello - привет
this - это
my - моя
semester - семестровая
work - работа
you - ты
smartie - умничка
oyou - ты
he - он
his - его
she - она
they - они
was - был, была
are - являемся, являетесь
and - и
when - когда
time - время, срок
number - число, количество
way  - дорога, путь
people - люди, население
some - которые
more - больше
make - делать, создавать
as - как, так как
for - для, из-за
in - в
on - на
word - слово
all - все, всё
this - этот, эта
we - мы
your - твой, ваш
be - быть, находиться
have - иметь
had - имел
were - были, находились
can - умеет, может
said - сказал, сказала
at - у
or - или
but - но, а
not - не
vacation - отпуск
polly - Поля
vacancy - пробел 
vacant - свободный 
apple - яблоко
vacate - покидать 
ne - один, единица